#;#;#;#;#;#;#;#;#;#;#;#;#;#;#;#;#;#;#;#;#;#;#;#
#;jugador;.;.;.;C;C;C;C;C;M;.;.;.;.;.;.;.;.;.;.;.;.;#
#;.;.;.;#;#;#;#;#;#;#;.;#;#;.;.;.;.;.;.;.;.;.;#
#;.;.;.;#;;;;;;#;.;#;#;.;.;.;.;.;.;.;.;.;#
#;.;.;.;#;;;;;;#;.;#;#;.;.;.;.;.;.;.;.;.;#
#;M;M;M;#;;;;;;#;.;#;#;.;.;.;.;.;.;.;.;.;#
#;.;.;.;#;#;#;#;#;;#;M;#;#;.;.;.;.;.;.;.;.;.;#
#;.;.;.;.;.;.;Shooter(position,2, 270);#;;#;.;#;#;.;.;.;.;.;.;.;.;.;#
#;.;.;.;#;#;#;#;#;;#;.;#;#;.;.;.;.;.;.;.;.;.;#
#;.;.;.;#;.;.;.;#;#;#;.;#;#;.;.;.;.;.;.;.;.;.;#
#;.;D;.;#;.;.;.;.;.;.;.;#;#;.;.;.;.;.;.;.;.;.;#
#;.;.;$;#;.;.;.;#;#;#;#;#;#;.;.;.;.;.;.;.;.;.;#
#;.;.;#;#;#;#;.;#;;;;;#;Shooter(position,2, 0);.;Shooter(position,2, 0);.;Shooter(position,2, 0);.;Shooter(position,2, 0);.;Shooter(position,2, 0);#
#;.;.;#;.;M;.;.;#;;;;;#;#;#;#;#;#;#;#;#;#;#
#;.;.;#;.;#;.;.;#;;;;;;;;;;;;;;;
#;M;M;#;$;#;.;.;#;;;;;;;;;;;;;;;
#;.;.;#;#;#;.;.;#;;;;;;;;;;;;;;;
#;.;.;.;.;.;.;$;#;;;;;;;;;;;;;;;
#;#;#;#;#;#;#;#;#;;;;;;;;;;;;;;;
